w w w w w w w w w w w w w
w e r w d i w i r w e r w
g g g s g k u k g g g g g
g g g g s g g g g g g g g
g g a s g g g g g s g g g
g g g g g g s g g g g g g
g g g g g g a g s g g g g
g g s g g g a g g g g g g
g g g g g g g g g g g g g
g g g g g g g g g g g g g